100
WRWWLWWLWWLWLWRRWRWWWRWWRWLW WWRRWLWLWWLWWLWWRWWRWWLW
WW WW
WRWLWLWRWRRWLWLWRWLWLWWRRWLWWLWLWRRWRWLWLWRRWWRWRRWLWLWWLWRRWLWLWRWRWLWLWRWLW WRWLWLWRWLW
WWWLWLWRRWLWLWWLWRW WLWRWWRWWRWWLWLWWRRWLWLWRRWRWLWLWRRWWLW
WWRWLWLWRRWLWLWRRWLWWLWLWRRWWWWRRWLWLWRRWRWLWLWRRWLWLWRWWWWRWLWLWW WWLW
WLWWRWLWLWRWWRWRRWLWLWRRWLWLWRWRWLWLWRRWLWLWRRWLWWLWLWRRWRWLWLWRWRWLWWLWLWRRWWRWLW WRWLWLWRWWRWLWLWRWWWLW
WRWLWWLWLWRRWWRRWLWLWRRWLWLWRWWRRWWLWWLWLWRWWLWRWRRWLWLWRRWLWLWW WLWRWRRWLWLWWRRWLWLWWLWWLWRRWWRRWLWLWRWLWLWWRWLW
WWWLW WLWWWRRWWWWWW
WWWWWWWWRRWWWWWWWLW WLW
WWRWLWLWRWRRWLWLWWWLWLWRRWRWWLWLWWRWRRWLWLWRRWLWWLWLWRRWRWWLW WRWLWLWRWLWLWWRWRRWLWWLWLWRRWLWLWWRWWRWRRWLWLWRRWLWLWWLWRWLWLWRRWLW
WLWRWLWWLWLWRRWW WLWRWWRWLWWLWLWRRWWWRRWLWLWRRWRWLWLWRWLW
WWWLW WWRRWLWLWRRWLWLWWLWWRWRRWLWLWRRWLWLWRRWWWLW
WWWWWWWWWWWLW WLWWWRRWWWWWWWWWWWWWW
WWRWRWLW WRWLWLWW
WLW WLWRWLWLWRRWRWWLWLWRWLWLWRRWRWRWLWLWRRWWRWLWLWW
WWWWWWWLW WLWWWRRWWWWWWWWWW
WLWRWRWLWWLWLWRRWRWRWLWWLWLWRRWWRRWLWLWRWLWLWRWLWLWRRWW WLWRWLWLWRWRRWLWLWRWRRWLWLWRWLWLWWRRWLWLWRRWRWLWLWWLWRWLWLWRW
WWWWWWWWWWWRRWWWWWWLW WLWWWWW
WRWLWWLWLWRRWLWLWRWLWLWRRWRWLWLWRW WLWRWWLWLWWRWRWRRWLWLWWLWRRWLWLWRRWLWWLWLWRRWWRRWLWLWRWWRWRRWLWWLWLWRRWLWLWWRWLW
WWRRWLWLWWWLWLWRRWW WLWRWLWLWRRWWRRWLWLWWLWRRWWLW
WWLWLWRRWLWLWRWRRWLWLWWLWRRWLW WWWWWRWW
WLWRRWLWLWRW WLWWRRWLWLWWLWRRWLWLWRRWLWLWRRWLWLWRRWLWWWLWLWWRRWWWRWLWLWRRWLWWLWLWRRWRWRWWWRWLWLWRWWWWWWWWLW
WLWWWRWLWLWRRWLWLWRRWLWLWRWRRWLWLWWWLWLWRRWRWLWLWRRWRWWWWWWWWRRWLWLWWLWRRWLWLWRW WLWW
WWLWLWRRWRWLWLWRWRRWLWLWWLWRRWLWLWRWWRRWLWLWWLWRRWLWLWRRWLWWLWLWRRWWRWLWLWRRWLW WWRWLWLWRWWWWWRWLWLWRWWWWWW
WWWWWWWWWWLW WLWWRRWWWWWWWWWWWW
WWWWWWWWWLW WRWWWWWWWWW
WWWWWRRWWWWLW WLW
WRWWLWLWWWLWRRWWRRWLWWWLWLWWRWLWRRWRWLWWWLWLWWRRWWRWRWLWWLWLWRRWLW WWWWLW
WLWWRRWLWLWRWWRRWWLWLWWWLWRWLW WRWLWLWRRWLWLWRRWWRRWLWLWWWWLWLWWRRWWW
WLWRWRWLWLWRWRRWLWLWRRWWRWLWLWW WLW
WWWWWWWWWWRRWWLW WLWWWWWWWW
WWWWWW WWWWWW
WLWWWWWWWWW WWWWWWWWWWRRWLW
WWW WWW
WWRWLWLWRRWLWLWRWRRWLWWLWWLWLWRRWWLWLWRRWRWLWLWRWRRWLWLWWLWRRWLWLWRWLW WRWLWLWRRWWLWLWWRRWWRWLWWWLWLWWRRWWRWLWLWRWWRWLWWLWLWRRWWRRWLWLWRRWLWLWW
WLWRRWLWWLWLWRRWWWLW WLWRWLWLWRWRRWLWLWWLWRRWLWLWRWWWWRWRRWLWWLWLWRRWWRRWLWLWWLWRWWWWRWLWWWLWLWWRRWWWWW
WWRWRRWLWLWWWLWLWRRWLW WLWWWWRRWLWLWRRWRWLWLWRRWLWLWRRWLWLWRWWWLW
WLWWRRWWWWWLW WLWRRWWWWLW
WWLWLWRRWRWWLWWWLWLWWRRWLWLWRRWWLW WRWLWLWRWRWWLWWLWLWRWRWWRRWWLWLWRWLWLWRRWRWLWLWWLWWWRRWWWRWLWLWRRWRWLWLWRRWWLWLWWRRWWLWLWWRRWLWLWW
WLWWWWWRRWWWWWWWWWWWWWRRWWLW WLWWWWWWLW
WLWWRWWRWWWWWRWLW WWLWLWRRWWRRWLWLWRRWWLWLWWWWLWLWRRWRWLWLWWLWWRW
WWWRWRRWLWLWWLWRRWLWWLWLWRRWRWLWLWRWRWWLWLWWRWWRRWWLWLWWWLWRRWWLWLWRWLWLWRRWWRWLWLWRRWWRRWLWLWRWLW WRWLWWLWLWRWLWRWRWLWLWRRWLWLWRRWLWLWRWWRRWLWWLWLWRWWLWLWRRWRWLWLWRWRRWLWLWWLWW
WLWLW WLWWWRRWWWWWWWWWWWWWRRWWWWWWWWWLW
WWLWLWRRWLWLWRWRRWLWLWWLWRWWWLW WLWRWLWLWRWWWWWRWRWRRWLWLWWLWRRWLWLWRWRRWLWLWWLWRWRWLWWLWLWRRWRWLWWLWLWRRWWWWWRWW
WLWW WWWWWWWWWWWWWWWRRWWWWWWWWWWWWWLW
WRWLWWLWLWRWLWRRWLWLWRWRRWLWWLWLWRRWRWRWLWLWRRWLWLWRWWW WWLWLWRRWLWLWRRWWLW
WWWRRWWLW WLW
WLWWRWLWLWRRWRWWLWLWWRRWWLWLWRRWLWLWRWLWLWWRRWWLW WWRWLWLWRWRRWLWLWRRWLWLWRWRRWLWLWWLWRRWWLWLWWRW
WLWWWW WWWWWWWWWWWWWWWRRWWWWWWWWWWWLW
WWWWWWWWWWWWWWLW WLWRRWWWWWWWWWWWWWWW
WLWWWWRRWWWWWWWWWWWLW WLWRRWWWWWWWWLW
WRWLWLWRRWLWWLWLWRRWLW WWLWLWRWRRWLWLWWLWRRWRWLWLWRRWRWLWWLWLWRRWRWLWWLWLWRRWRWLWLWRRWWLW
WLW WLWWRRWLWLWRRWWRRWLWLWW
WWRWLWLWRRWLWLWRWWWWRRWLWLWRRWRWLWWLWLWRRWRWLWLWRWWWW WWLWLWW
WRWLWLWRRWWLWLWWRWRRWLWLWWLWRRWWLWLWRWLWLWRRWRWWLWLWWRWRRWLWLWWLWRRWRWWLWLWWW WWLWLWRRWRWLWLWRRWLWLWRRWWLWLWWRWRRWLWLWRWLWWLWLWRWRRWLWLWRWRRWLWLWWLWRRWRWLWLWRWLW
WLWLW WLWRRWWRW
WWWLWWLWLWRWRRWLWLWRRWLWLWW WWWRRWLWLWRWWRWWLWWLWLWRWRRWLWLWRRWWRWWLW
WWWWWWWWWWRRWWWLW WLWWWWWWW
WLWWWWWW WWWWWWRW
WRWLWLWRWRRWLWLWWWWLWLWWRRWWRWLWWLWLWRRWRWLWLWRRWWRRWLWLWRRWLWLWRRWLWLWRRWLWLWW WWLWLWRRWLWLWRRWLWWLWLWRRWRWWLW
WWWWWRRWLW WLWWWW
WWWWRRWWLWLWWW WWLWLWRRWRWLWLWRWRRWLWLWRRWLWLWW
WRWWWW WWWWLW
WLWRWLWLWRWWWRWRWRRWLWLWWWLWLWRRWWWRRWLWLWWLWRRWLWLWRRWW WLWWLW
WWWWWWWWWWWWWW WWWWWWWWWWWWWW
WWLWLWRWRRWLWLWRWRRWLWWLWLWRRWW WLWWW
WWWWRW WLWWWW
WLWWWWWRRWWWWWWWWWWWWWWW WWWWWWWWWWLW
WLWWWWW WWWWWWRRWLW
WWWWLW WLWWWWWRRWWWWWWWWW
WWLWWWLWLWWRRWWRWWRRWLWLWWLWRRWWLWLWWRRWWLWLWWRWRRWLWLWW WWLWLWRWRRWLWLWRWRRWLWLWWLWRRWWLWLWWRRWWLWLWWRWW
WLWRRWLWWLWLWRRWRWWRWLWLWRRWLWLWRRWRWLWLWRRWLW WWLWRWLWLWWLWRRWLW
WWRRWLWLWRRWLWLWRRWLWLWRWRRWLWLWRRWWLW WLWWLW
WLWLW WRWLWLWRRWLWLWRRWLWLWRRWLWWWLWLWWRRWWWWWRRWLWLWRRWRWLWLWRRWLWLWRWWWWWWW
WWWW WWWW
WLWWWRRWWLWLWWRRWWLW WLWWWRRWLWLWRRWRWLWWLWLWRW
WLWWWRRWWLWLWWRWLW WRWLWWWLWLWWRRWWRWRWLWLWRW
WWLWLWRRWLWLWRWRWWRRWWLWLWWW WWLWWLWLWRRWRWLWLWRRWWRRWLWLWW
WWWW WWWW
WWLW WRWLWLWRRWRWLW
WLWRWRRWLWLWWLWRRWRWLWLWRWRRWLWLWRWW WLWRRWLWLWWLWW
WRW WLW
WRWLWLWRRWLWLWRRWRWWW WLWLW
WWLWLWRRWLWLWRRWLWLWRRWLWLWRWRRWLWLWRW WLWWWWWWRRWLWLWRRWLW
WLWRRWLWLWRRWLWLWRRWWRRWLWWLWLWRWLWRWRRWLWLWW WLWRRWLWWLWLWRRWWLW
WRWWWWWW WWWWWWLW
WWWWWWWLW WLWWRRWWWWWWWWW
WWLW WRWLWWLWLWRWLWRRWRWLWLWRRWWLWLWWRRWWLWLWRWLWLWRRWRWWRRWLWLWRWWWWLW
WLWWWRWRWRRWLWLWWLWW WLWWWRRWWWLWLWWWRRWWLW
WRWLWLWRRWLWLWRRWLWLWRRWLWLWRRWLWLWRRWLW WWWWWWRWLW
WLWRWWRRWWLWLWWWWLWLWRRWRWLWLWRWWRRWLWLWWLWRRWLWLWRWRRWLWLWRWLWLWRRWLWLWRWLWLWWRRWWRWWLW WRWLWLWRWWRWLWWLWLWRRWRWLWLWRWRRWLWLWRWLWLWWRWRRWLWLWWLWRRWLWLWRRWLWLWRWRRWLWLWW
WWWWWW WWWWWW
WWLWLWRRWWRWLWLWRRWLWLWRRWLWLWRWWRWLWLWW WWLWLWRRWRWWRWLWWLWLWRRWWWWRWLWLWRWW
WLWRWWRWLWLWRWWRWLWLWRRWLWLWRRWLWLWRW WLWRWWWRWLWLWRRWLWLWRWRWLWLWRRWLWLWRW
WLW WWRRWLW
WWLWLWRW WLWRWLWLWRRWRWLWLWRRWRWLWLWRRWLW
WLWWRRWLWLWRRWLWLWRRWRWWLWLWRWLWLWRRWWWRRWWLWLWWWLWRWRWLWWLWLWRRWRWWLWLWWRRWWRWWRRWLWLWWRWLWLWWLWRW WLWWRRWLWLWWWWLWLWWRRWWLW
WLWWWLW WLWWWWRRWWWWWWWWWRRWWLW
WWWWWW WWWWWW
WLWWWRRWWWWWWWLW WLWWWRRWWWWWWWLW